1111111111111111111111111111111111
1E000000000P000C00000C000000000001
1010010100100000101001000000010101
1111111111111111111111111111111111