1111111111
1P00PCE101
1111111111